Equipe 1 :

Alla	  		Abdelouahad   	
Ndjonkam  		Innocent      	 
Moffa  	 		Jeremy	

Equipe 2 :

Mujyabwami		Arsene 
Oleinik 			Roman 
Ark 			Ogün 

Equipe 3 :
Scalea 			Adrien 
Gomila Otero		Alvaro
Maison 			Lucas 

Equipe 4 :

Dauchot 			Randy 
Goffinet 		Nicolas 
Brenart			Thomas 


Equipe 5 :

Vandekerckhove		Adrien Foucoux 			Noa 
Ibraimovski		Roméo

Equipe 6 :

Lole 			Junior
Kerckhofs		Guillaume 
Tazribine 		Ali

Equipe 7 :

Spinosi 			Alessandro
Vallois 			Nicolas 
Subtil Galvao 		Matilde 

Equipe 8 :

Fondja 			Ingrid 
Ndjopmou			Mael
Pondi 			Emmanuel 

Equipe 9 :

Michel 			Simon
Surin 			Virgil 
Vanhaverbeke		Maximilien 

Equipe 10 :

Samain 			Clément
Lemaire 			Emilien
Sournac 			Nicolas

Equipe 11 :

Estievenart 		Yorick 
Venturoso 		Hugo
Moreau 			Nicolas 


Equipe 12 :

Desobry 			Naomi
Allard 			Clément 
Iakovenko		Maksym